..............................
...######.....................
..............................
..........######..............
..............................
....###.......................
..............................
....................###........
..............................
......######..................
..............................
..........######..............
..............................
....###.......................
..............................
....................###........
..............................
.......#####..................
..............................
..............#####...........
..............................
....###.......................
..............................
....................###........
..............................
......######..................
..............................
..............................